"filename", "language", "JavaScript", "CSS", "Markdown", "HTML", "comment", "blank", "total"
"c:\Users\kbreenbondie\OneDrive - Arbor Oakland Group\Documents\GitHub\Hunters_Site\Button.js", "JavaScript", 87, 0, 0, 0, 7, 20, 114
"c:\Users\kbreenbondie\OneDrive - Arbor Oakland Group\Documents\GitHub\Hunters_Site\GameManager.js", "JavaScript", 448, 0, 0, 0, 49, 51, 548
"c:\Users\kbreenbondie\OneDrive - Arbor Oakland Group\Documents\GitHub\Hunters_Site\GameObject.js", "JavaScript", 22, 0, 0, 0, 0, 4, 26
"c:\Users\kbreenbondie\OneDrive - Arbor Oakland Group\Documents\GitHub\Hunters_Site\MenuIcon.js", "JavaScript", 40, 0, 0, 0, 4, 7, 51
"c:\Users\kbreenbondie\OneDrive - Arbor Oakland Group\Documents\GitHub\Hunters_Site\Patrol.js", "JavaScript", 421, 0, 0, 0, 32, 38, 491
"c:\Users\kbreenbondie\OneDrive - Arbor Oakland Group\Documents\GitHub\Hunters_Site\README.md", "Markdown", 0, 0, 9, 0, 0, 3, 12
"c:\Users\kbreenbondie\OneDrive - Arbor Oakland Group\Documents\GitHub\Hunters_Site\Ship.js", "JavaScript", 125, 0, 0, 0, 7, 20, 152
"c:\Users\kbreenbondie\OneDrive - Arbor Oakland Group\Documents\GitHub\Hunters_Site\Sprite.js", "JavaScript", 252, 0, 0, 0, 51, 43, 346
"c:\Users\kbreenbondie\OneDrive - Arbor Oakland Group\Documents\GitHub\Hunters_Site\TacticalView.js", "JavaScript", 348, 0, 0, 0, 18, 34, 400
"c:\Users\kbreenbondie\OneDrive - Arbor Oakland Group\Documents\GitHub\Hunters_Site\TorpedoButton.js", "JavaScript", 99, 0, 0, 0, 17, 8, 124
"c:\Users\kbreenbondie\OneDrive - Arbor Oakland Group\Documents\GitHub\Hunters_Site\UI.js", "JavaScript", 272, 0, 0, 0, 22, 31, 325
"c:\Users\kbreenbondie\OneDrive - Arbor Oakland Group\Documents\GitHub\Hunters_Site\Uboat.js", "JavaScript", 312, 0, 0, 0, 29, 26, 367
"c:\Users\kbreenbondie\OneDrive - Arbor Oakland Group\Documents\GitHub\Hunters_Site\index.html", "HTML", 0, 0, 0, 71, 1, 4, 76
"c:\Users\kbreenbondie\OneDrive - Arbor Oakland Group\Documents\GitHub\Hunters_Site\init.js", "JavaScript", 6, 0, 0, 0, 0, 2, 8
"c:\Users\kbreenbondie\OneDrive - Arbor Oakland Group\Documents\GitHub\Hunters_Site\main.js", "JavaScript", 58, 0, 0, 0, 5, 11, 74
"c:\Users\kbreenbondie\OneDrive - Arbor Oakland Group\Documents\GitHub\Hunters_Site\popups\AttackDepthAndRangePopup.js", "JavaScript", 71, 0, 0, 0, 7, 13, 91
"c:\Users\kbreenbondie\OneDrive - Arbor Oakland Group\Documents\GitHub\Hunters_Site\popups\EncounterPopup.js", "JavaScript", 115, 0, 0, 0, 8, 23, 146
"c:\Users\kbreenbondie\OneDrive - Arbor Oakland Group\Documents\GitHub\Hunters_Site\popups\OrdersPopup.js", "JavaScript", 91, 0, 0, 0, 8, 16, 115
"c:\Users\kbreenbondie\OneDrive - Arbor Oakland Group\Documents\GitHub\Hunters_Site\popups\Popup.js", "JavaScript", 174, 0, 0, 0, 12, 23, 209
"c:\Users\kbreenbondie\OneDrive - Arbor Oakland Group\Documents\GitHub\Hunters_Site\popups\ResupplyPopup.js", "JavaScript", 156, 0, 0, 0, 8, 14, 178
"c:\Users\kbreenbondie\OneDrive - Arbor Oakland Group\Documents\GitHub\Hunters_Site\popups\StatusPopup.js", "JavaScript", 114, 0, 0, 0, 5, 10, 129
"c:\Users\kbreenbondie\OneDrive - Arbor Oakland Group\Documents\GitHub\Hunters_Site\styles.css", "CSS", 0, 18, 0, 0, 0, 5, 23
"c:\Users\kbreenbondie\OneDrive - Arbor Oakland Group\Documents\GitHub\Hunters_Site\styles\EncounterPopup.css", "CSS", 0, 74, 0, 0, 0, 6, 80
"c:\Users\kbreenbondie\OneDrive - Arbor Oakland Group\Documents\GitHub\Hunters_Site\styles\Popup.css", "CSS", 0, 64, 0, 0, 0, 9, 73
"c:\Users\kbreenbondie\OneDrive - Arbor Oakland Group\Documents\GitHub\Hunters_Site\styles\StatusPopup.css", "CSS", 0, 169, 0, 0, 0, 23, 192
"c:\Users\kbreenbondie\OneDrive - Arbor Oakland Group\Documents\GitHub\Hunters_Site\styles\styles.css", "CSS", 0, 40, 0, 0, 1, 9, 50
"c:\Users\kbreenbondie\OneDrive - Arbor Oakland Group\Documents\GitHub\Hunters_Site\util.js", "JavaScript", 51, 0, 0, 0, 6, 8, 65
"Total", "-", 3262, 365, 9, 71, 297, 461, 4465