"filename", "language", "JavaScript", "CSS", "comment", "blank", "total"
"c:\Users\kbreenbondie\OneDrive - Arbor Oakland Group\Documents\GitHub\Hunters_Site\Encounter.js", "JavaScript", 48, 0, 10, -2, 56
"c:\Users\kbreenbondie\OneDrive - Arbor Oakland Group\Documents\GitHub\Hunters_Site\GameManager.js", "JavaScript", 26, 0, 8, 4, 38
"c:\Users\kbreenbondie\OneDrive - Arbor Oakland Group\Documents\GitHub\Hunters_Site\PatrolLog.js", "JavaScript", 8, 0, -1, -2, 5
"c:\Users\kbreenbondie\OneDrive - Arbor Oakland Group\Documents\GitHub\Hunters_Site\Ship.js", "JavaScript", 0, 0, 1, 1, 2
"c:\Users\kbreenbondie\OneDrive - Arbor Oakland Group\Documents\GitHub\Hunters_Site\Sprite.js", "JavaScript", 9, 0, 8, 2, 19
"c:\Users\kbreenbondie\OneDrive - Arbor Oakland Group\Documents\GitHub\Hunters_Site\SpriteUboat.js", "JavaScript", -1, 0, 4, -1, 2
"c:\Users\kbreenbondie\OneDrive - Arbor Oakland Group\Documents\GitHub\Hunters_Site\SpriteWake.js", "JavaScript", -6, 0, 8, 0, 2
"c:\Users\kbreenbondie\OneDrive - Arbor Oakland Group\Documents\GitHub\Hunters_Site\TacticalView.js", "JavaScript", 26, 0, 2, 4, 32
"c:\Users\kbreenbondie\OneDrive - Arbor Oakland Group\Documents\GitHub\Hunters_Site\Uboat.js", "JavaScript", 4, 0, 1, 0, 5
"c:\Users\kbreenbondie\OneDrive - Arbor Oakland Group\Documents\GitHub\Hunters_Site\main.js", "JavaScript", 28, 0, 6, 4, 38
"c:\Users\kbreenbondie\OneDrive - Arbor Oakland Group\Documents\GitHub\Hunters_Site\popups\AircraftPopup.js", "JavaScript", -79, 0, -7, -14, -100
"c:\Users\kbreenbondie\OneDrive - Arbor Oakland Group\Documents\GitHub\Hunters_Site\popups\FollowTimePopup.js", "JavaScript", 8, 0, 1, 0, 9
"c:\Users\kbreenbondie\OneDrive - Arbor Oakland Group\Documents\GitHub\Hunters_Site\popups\StatusPopup.js", "JavaScript", 62, 0, 4, 7, 73
"c:\Users\kbreenbondie\OneDrive - Arbor Oakland Group\Documents\GitHub\Hunters_Site\styles\StatusPopup.css", "CSS", 0, 31, 0, 6, 37
"Total", "-", 133, 31, 45, 9, 218