"filename", "language", "CSS", "Markdown", "JavaScript", "HTML", "comment", "blank", "total"
"c:\Users\kbreenbondie\OneDrive - Arbor Oakland Group\Documents\GitHub\Hunters_Site\Encounter.js", "JavaScript", 0, 0, 805, 0, 80, 83, 968
"c:\Users\kbreenbondie\OneDrive - Arbor Oakland Group\Documents\GitHub\Hunters_Site\GameManager.js", "JavaScript", 0, 0, 276, 0, 24, 32, 332
"c:\Users\kbreenbondie\OneDrive - Arbor Oakland Group\Documents\GitHub\Hunters_Site\GameObject.js", "JavaScript", 0, 0, 24, 0, 0, 4, 28
"c:\Users\kbreenbondie\OneDrive - Arbor Oakland Group\Documents\GitHub\Hunters_Site\MenuIcon.js", "JavaScript", 0, 0, 40, 0, 4, 7, 51
"c:\Users\kbreenbondie\OneDrive - Arbor Oakland Group\Documents\GitHub\Hunters_Site\Patrol.js", "JavaScript", 0, 0, 421, 0, 32, 38, 491
"c:\Users\kbreenbondie\OneDrive - Arbor Oakland Group\Documents\GitHub\Hunters_Site\PatrolLog.js", "JavaScript", 0, 0, 102, 0, 10, 15, 127
"c:\Users\kbreenbondie\OneDrive - Arbor Oakland Group\Documents\GitHub\Hunters_Site\README.md", "Markdown", 0, 9, 0, 0, 0, 3, 12
"c:\Users\kbreenbondie\OneDrive - Arbor Oakland Group\Documents\GitHub\Hunters_Site\Ship.js", "JavaScript", 0, 0, 158, 0, 8, 27, 193
"c:\Users\kbreenbondie\OneDrive - Arbor Oakland Group\Documents\GitHub\Hunters_Site\Sprite.js", "JavaScript", 0, 0, 301, 0, 64, 58, 423
"c:\Users\kbreenbondie\OneDrive - Arbor Oakland Group\Documents\GitHub\Hunters_Site\TacticalView.js", "JavaScript", 0, 0, 325, 0, 47, 41, 413
"c:\Users\kbreenbondie\OneDrive - Arbor Oakland Group\Documents\GitHub\Hunters_Site\UI.js", "JavaScript", 0, 0, 268, 0, 23, 30, 321
"c:\Users\kbreenbondie\OneDrive - Arbor Oakland Group\Documents\GitHub\Hunters_Site\Uboat.js", "JavaScript", 0, 0, 638, 0, 77, 49, 764
"c:\Users\kbreenbondie\OneDrive - Arbor Oakland Group\Documents\GitHub\Hunters_Site\buttons\BeginPatrolButton.js", "JavaScript", 0, 0, 14, 0, 1, 2, 17
"c:\Users\kbreenbondie\OneDrive - Arbor Oakland Group\Documents\GitHub\Hunters_Site\buttons\Button.js", "JavaScript", 0, 0, 79, 0, 14, 13, 106
"c:\Users\kbreenbondie\OneDrive - Arbor Oakland Group\Documents\GitHub\Hunters_Site\buttons\ContinuePatrolButton.js", "JavaScript", 0, 0, 11, 0, 1, 2, 14
"c:\Users\kbreenbondie\OneDrive - Arbor Oakland Group\Documents\GitHub\Hunters_Site\buttons\DeckGunButton.js", "JavaScript", 0, 0, 91, 0, 8, 8, 107
"c:\Users\kbreenbondie\OneDrive - Arbor Oakland Group\Documents\GitHub\Hunters_Site\buttons\FireAttackButton.js", "JavaScript", 0, 0, 11, 0, 1, 2, 14
"c:\Users\kbreenbondie\OneDrive - Arbor Oakland Group\Documents\GitHub\Hunters_Site\buttons\OpenStatusButton.js", "JavaScript", 0, 0, 12, 0, 1, 2, 15
"c:\Users\kbreenbondie\OneDrive - Arbor Oakland Group\Documents\GitHub\Hunters_Site\buttons\ReloadButton.js", "JavaScript", 0, 0, 18, 0, 1, 5, 24
"c:\Users\kbreenbondie\OneDrive - Arbor Oakland Group\Documents\GitHub\Hunters_Site\buttons\TorpedoButton.js", "JavaScript", 0, 0, 196, 0, 30, 8, 234
"c:\Users\kbreenbondie\OneDrive - Arbor Oakland Group\Documents\GitHub\Hunters_Site\index.html", "HTML", 0, 0, 0, 83, 3, 7, 93
"c:\Users\kbreenbondie\OneDrive - Arbor Oakland Group\Documents\GitHub\Hunters_Site\init.js", "JavaScript", 0, 0, 6, 0, 0, 2, 8
"c:\Users\kbreenbondie\OneDrive - Arbor Oakland Group\Documents\GitHub\Hunters_Site\main.js", "JavaScript", 0, 0, 63, 0, 8, 15, 86
"c:\Users\kbreenbondie\OneDrive - Arbor Oakland Group\Documents\GitHub\Hunters_Site\popups\AttackDepthAndRangePopup.js", "JavaScript", 0, 0, 73, 0, 7, 13, 93
"c:\Users\kbreenbondie\OneDrive - Arbor Oakland Group\Documents\GitHub\Hunters_Site\popups\EncounterPopup.js", "JavaScript", 0, 0, 121, 0, 9, 22, 152
"c:\Users\kbreenbondie\OneDrive - Arbor Oakland Group\Documents\GitHub\Hunters_Site\popups\EscortDetectionPopup.js", "JavaScript", 0, 0, 111, 0, 5, 17, 133
"c:\Users\kbreenbondie\OneDrive - Arbor Oakland Group\Documents\GitHub\Hunters_Site\popups\FollowPopup.js", "JavaScript", 0, 0, 54, 0, 10, 14, 78
"c:\Users\kbreenbondie\OneDrive - Arbor Oakland Group\Documents\GitHub\Hunters_Site\popups\FollowTimePopup.js", "JavaScript", 0, 0, 33, 0, 3, 9, 45
"c:\Users\kbreenbondie\OneDrive - Arbor Oakland Group\Documents\GitHub\Hunters_Site\popups\OrdersPopup.js", "JavaScript", 0, 0, 91, 0, 8, 16, 115
"c:\Users\kbreenbondie\OneDrive - Arbor Oakland Group\Documents\GitHub\Hunters_Site\popups\Popup.js", "JavaScript", 0, 0, 174, 0, 12, 23, 209
"c:\Users\kbreenbondie\OneDrive - Arbor Oakland Group\Documents\GitHub\Hunters_Site\popups\ResupplyPopup.js", "JavaScript", 0, 0, 156, 0, 8, 14, 178
"c:\Users\kbreenbondie\OneDrive - Arbor Oakland Group\Documents\GitHub\Hunters_Site\popups\RoundFollowUpPopup.js", "JavaScript", 0, 0, 87, 0, 7, 11, 105
"c:\Users\kbreenbondie\OneDrive - Arbor Oakland Group\Documents\GitHub\Hunters_Site\popups\RoundResultsPopup.js", "JavaScript", 0, 0, 118, 0, 9, 18, 145
"c:\Users\kbreenbondie\OneDrive - Arbor Oakland Group\Documents\GitHub\Hunters_Site\popups\StatusPopup.js", "JavaScript", 0, 0, 170, 0, 26, 22, 218
"c:\Users\kbreenbondie\OneDrive - Arbor Oakland Group\Documents\GitHub\Hunters_Site\styles.css", "CSS", 18, 0, 0, 0, 0, 5, 23
"c:\Users\kbreenbondie\OneDrive - Arbor Oakland Group\Documents\GitHub\Hunters_Site\styles\EncounterPopup.css", "CSS", 132, 0, 0, 0, 0, 12, 144
"c:\Users\kbreenbondie\OneDrive - Arbor Oakland Group\Documents\GitHub\Hunters_Site\styles\Popup.css", "CSS", 65, 0, 0, 0, 0, 9, 74
"c:\Users\kbreenbondie\OneDrive - Arbor Oakland Group\Documents\GitHub\Hunters_Site\styles\StatusPopup.css", "CSS", 188, 0, 0, 0, 0, 25, 213
"c:\Users\kbreenbondie\OneDrive - Arbor Oakland Group\Documents\GitHub\Hunters_Site\styles\styles.css", "CSS", 40, 0, 0, 0, 1, 9, 50
"c:\Users\kbreenbondie\OneDrive - Arbor Oakland Group\Documents\GitHub\Hunters_Site\util.js", "JavaScript", 0, 0, 51, 0, 6, 8, 65
"Total", "-", 443, 9, 5098, 83, 548, 700, 6881